2 13 31
###############################
#p * *2       *  ** * *   3  *#
# # # # #*# # #*# # # # # #*# #
#    * * *** **  2    *    ** #
# #*# #x# # #1# #*#1# # # # #*#
# b        *     **      *  **#
#######*##############*########
#                             #
# #* *#  #   #                #
# # # #  #   #                #
# #   #  #*#*#                #
#                             #
###############################